22222222222222222222222222222222222222222222222222222222222222222222222222222222222222222222222222222222222222
22200002222222200000002222220000022222222220000000000000002222200000022222222222222222222222222222222222222222
22000000222222002222202220000220022220000000222222222222200222202222002222222222222222222222222222222222222222
20000200022220022222202220222200222200222222222000000222220022200002202222222222222222222222222222222222222222
20002220002220222222202200222002222202222220000022220222222022222202202222222222222222222222222222222222222222
20200000202220222222002202220022222202222200222222220000222000000002202222222222222222222222222200000000222222
22200002222220222222022200220022222202222002222200002220002222222222002222222222222222222222222202222222022222
22220002222220022222022220222002222202220022220002200222200000000000022222222222222222222222000020000000202222
22222022222222022222002220022200222002200222200222220022222222222222222222222222222222000222000200000000020222
20002022222222002222202222022220220022002222202222222002222222222222222222222222200000000000002000000000002022
20200022222222200222200222002220020222022222002220022200222222200022222002222222200000000000020000000000000202
20222222222222220022220000022222000222022220022200002220222220000022200000222220000000000000200000000000000202
20222222222222000022222222222222002220022200222002200220022200000002200000000000000000000000200000000000000202
20222222222222020022222222222222222220222202200022220022002000000002000000000000000000000000000000000000000202
20002222222222022222222220000022222220222002002222222002202000000000000000000000000000000000000000000000000202
22202222222222000000000000222022222220222022002220002200200000000000000000000000000000000000000000000000000202
22202022222222222222222222222022222220222002200200200220220000000000000000000000000000000000200000000000000202
22200022222222222222222222222000000220022200220002220020220000000000000000000000000000000000200000000000000202
22222022222222222000222000022222220222022220022222220020022000000002202000000000000000000000020000000000000222
22220022222002222020022022002222220222022222002222200222022220002022222000000000000000000000002000000000002022
22220222220000222022022022202222220222002222200220002220022220000222222220000000000000000000000200000000020222
22220200020220220022022022200222200222200222220000222220222220200222222222220022220222000000000020000000202222
22220002020220220222022022220020002222220022222222222200222220002222222222222222222222200000002202222222022222
22220022000220200222020022222000222222222002222222220002222220002222222222202222222222220222222220000000222222
22222222222220002222000222222222222222222200000000000222222220000022222222222220222222222222222222222222222222
22222222222222222222222222222222222222222222222222222222222220020022222222222222222222222222222222222222222222
22222222222222222222222222220022222222222222222222222222222220000222222222222222222222222222222222222222222222
22222222222222222222222222220022222222222022222222222222222220020222222222222222222222222222222222222222222222
22222222222222222222222222200000222222222222222222222222222220022222222202222222222222222222222222222222222222
22222222222222222222220022222222222222222222222220222222222220022222222222222222222222222222222222222222222222
22222222222222222222222222222222222222222222222222222222222200022222222222222222222222222222222222222222222222
22222222222222222222222222222222222222222222222222222222222200022222222222222222222222222222222222222222222222
22222222222222222222222222222000000000000000000022222222222220020222222222222222222222222222222222002222222222
22222200002222220222222222000022222222222222222002222222222222000022222222222000002222222222222222200222222022
22222000000000000222222222000002222222222222222202222222222222200022222222200022200000000000002222220022220022
22220000000000002222222222000000000000022222222200222222222222222022222222202222222222222222200022222000220222
22220000000000000022222222202222222222000222222220220000022222222002222222202222222222222222222002222220000222
22220000000000022002222222222222222222220000000220000222002222222002222222002222222222222222222202222222022222
22220000000002222202222222222222222222222020220022222222200222222022222222022222222220000022222002222220022222
22200220002222222200000022222222222222222022222022222222220022222022222222022222222200222022222202222000222222
22202222222222222220000022222222222200222022222022222222222002222022222222002222222202222002222202222022222222
22202222222222222220000222222222222000000022222022222222222200222022222222200220000002222202222202220022222222
22202222222222222220000002222222220000002222220022222000022220220022222222220200222222222202222202000222222222
22002222000000222220000002222222200000002222200222220022002220220222222222220202222222222202222200022222222222
22000222020220022222222022222222000000002222202222220222202220220002222222220002222222222002222222222222222222
22000222022222022222220022222222000000022222202222220222200200222200022000000222222222220022222222222222222222
22222222002222002222220022222222000000022222200222200222220002222222000022222222222222220222222222222220000022
22222222200222202222222000020222000002222222220000002222222222222222222222222222222222220222222222222220020022
22222222220222200222222222000000000022222222222222222222222222222222222222222222222222000222222222222220020022
22222220000222220222222222000000000022222222222222222200002222222222222222222222222220022222222222222220000222
22222220222222220002222222000000000022222222222222222000000222222222222222222220002200222222222222222222000222
22222220022222220022222220000000000000222222222222222000020222222222222222222200200002222222222222222220022222
22222222022222220222222000000022220000022222222222222220020222222222222222222202222202222220000000022200222222
22222000002222220002222000000022222000000000000000222000220022220000022222222002222222222220222222000002222222
22220020002222222202222000000022222200000000000000000000222000000222022202000022222222222220222222222222222222
22222020002222222000022022200222222220000000000000000000222222222222002000022222222222222220002222222222222222
22222022002222222000020022222222222220000002200000020002222222222222200022222222222222222222220000000222222222
22222022022222222220000222222222222222000222222000222222222222222222222222222222222000002222222222220000000022
22222020222222222220002222222222222222222222222222222222222222222222222222222222220022200222222222222222222022
22222020222222222222222222222222222222222222222222222222222222222222222222222222200222220000002222222222222022
22220022222222222222222222222222222222222222222222222222222222222222222222222222220222222222200000000000000022
22220022222222222222222222222222222222222222222222222222222222222222222222222222220002222222222220022222222222
22220022222222222222222200000002222222222222220222222222222220002200002222222222222200222222222222222222222222
22222022222220000000000002222200002222222200000000002222220000200002222222222222222202222222222222222222222222
22220022222220022222222222222220022222222222220222222222222222220222222222222000020002222220022000222222000022
22220222222222000222222222222222222222022222220222000222222222200222222000200022000022222200000020222200022022
22220000022222220002222222222222222220022220000000020020000000002222222020002220002222222202222220220002222022
22222222022222222200222000002222000220002200222022222000220222222222222022222220222222222200022220000000222022
22222222022000222200220022200220020220202002222222222002220222222222222022222220222222222000022222200002222022
22222222000020022000000222220000220020200022222222222222220002222222222002222220002222222002222222222002222002
22222222222222002022222222222222222000222222222222222222222200002222222002222222200222222200222222222202222002
22222222222222200022222222222222222222222222222222222222222222200002220022222222202222222220002222222202220022
22222222222222200220002222222222222222222202222202222222222222222200200222222220002222222200002222222000220022
22022222222222200220202222222222222220000002200000000222222022222220002222222000222222222200222222222000222002
22002000022222202222200002222222222220000222002200220022220000022222222200022000000222222220222222222000222200
22200022002000202222222202222222200000000200000222220022220000022222222202022222220222222200222222222200222202
22222222200020002222222202220022202000000000000000220222220000000000000002022222000222222002222200222002222002
22222222220222222222222202200022002000000000000000220022222222222222222222022222022222222000222000222000022022
22222222222222222222220000002000022200000022000022222002222222222222222000022220022222222000222000222200022022
22222222222222000022220222222222222220000222222222222200222222200002220022222220002222222202222002222200022022
22222222222220022022220222222222222222222222222222222220022222200002200222222222202222222202222222222220022022
22000222222220022002220022222222222222222222222222222222002222220002202222022222202222222202222222222222022022
22000002222222222200000022222222222222222222222222222222200022000002202220000222002222222002222222222000022022
22000000022222222222220022222222222220222200000222222222222020022022002200000000022222000022222222222200222022
22200000000022222222220022222002220000222202220022220000222000222020002200000020222222022222222222200000222022
22200000000002222222222000000002000220002002222002200220222222222000202000000022222222022222222200000022222022
22200000000000222222222222200000022222200022222200202220222222222222200022200022222222022222222200000022222022
22200000000000022222222222222222222222222222222220002220002222222222222222222222222222002222222220022222222022
22000000000000000222222222222222222222222222222222222222200002222222222222222222222222002222222200002222220022
22000000000000000022222222222222222222222222222222222222222200222222222222222222222220022222222000002222220222
22000000000000000002222222222222222222222222222222222222222220002222222222222222220000222222222000002222220222
22000000000000000000222222222222222222222222222222222222222222200222222222222222200222222222222000000022220022
22000000000000000022222222222222222222222222222222222222222222220002220200222222002222222222220000000022222022
22000222200022222222222222222222222222222222222222222222222222222202200000222220022222222222222000000022220022
22222222220002220000002222222222200000002222222222222220002222222200202220000000222222222222000000000022220222
22222222222000000000000222222222220000000000000002202220000222222220202220222022222222222200000000000222220222
22222200220000000000000002222222220000000000000000000000000222222220002200222222222222222000000000000222200222
22000000000000000000000000222222222000000000000000000000000022222222222202222222222222220000000000002222220222
22000000000000000000000000022222222000000000000000000000000000222222222200222222222222200000000000002222200022
22000000000000000000000000002222222200000000000000000000000000022222222220222222222022000000000000022222002222
22000000000000000000000000002222222200000000000000000000000000022222222220222222222000000000000000222222222222
22000000000000000000000000000222222200000000000000000000000000002222222200222220220000000000000000222222222222
22000000000000022000000000000022222220000000002220000000000000000222222002222200000000000000000022222222222222
22000000000000220200000000000022222220000000002222000000000000000022222022222000000000000000000022222222222222
22200000000000222220000000000002222220000000002222200000000000000002222002222000000000000000000002222222222222
22200000000022222220000000000000222222000000000222222000000000000000222222222000000000000000000022220222222222
22200000000022222222000000000000022222200000000222222000000000000000022222220000000000000000000222222222222222
22200000000222222222200000000000002222200000000222222200000000000000022222220000000000000000002222222222222222
22000000000222222222220000000000002222200000000022222200000000000000002222220000000000000000022222222222200022
22000000000022222222220000000000000222200000000022222220000000000000002222220000000000000000222222222220000022
22000000000002222222222000000000000222200000000022222222000000000000002222200000000000000002222222222200022222
22000000000000222222222000000000000222220000000022222222200000000000002222200000000000022222222222222000220022
22000000000000222222222000000000000022220000000222222222200000000000002222200000000000222222202222200000000022
22000000000000222222222200000000000000220000000222222222200000000000000222200000000000222222222200000022200022
22000000000000222222222200000000000000000000000222222222200000000000000022200000000002222222222200000022200022
22000000000000222222222222000000000000000000000222220000000000000000000022200000000002222222222200000022200022
22000000000022222222222222200000000000000000000222220222220000000000000000000000000002220222222220000000000022
22000000000022222222222222200000000000000000000022220222222200000000000000000000000002222222022222200000000022
22000000000022222222222222000000000000000000000022220020002220000000000000000000000002222220220000002222222222
22000000000002222222222222200000000000000000000022222000000222000000000000000000000002222222000000000222222222
22000000000002222222222022220000000000000000000022200000000022200000000000000000000000222220000000000000022222
22000000000022222222222222222000000000000000000222000000000002220000000000000000000022222000000000000000000022
22000000000222222222222222222000000000000000002220000000000000220000000000000000000222220000000000000000000022
22000000000222222222222222222222222222222222222200000000000000022222222222222222222222000000002220000000000022
22000000000222222222222222222222222222222222222220000000000000222222222222222222222220000000022220000000000022
22000000000222222222222222222222222200000200022222000000000000220220222222222222222200000000022220000000000022
22000000000022222222200022222222222200222220002222220000000002220022222202222222222000000000022222000000000222
22000000000002222222202022222222222200022200000222222222000222220022200022222222222000000000022220000000002222
22000000000000002222200022222222222200000000000220222222222222222000000000222222222200000000002200000000022222
22000000000000022220220222222222222200000000000220022222222200022000000000022222222200000000022220000000022222
22000000000000222222220222222222222000000000000022000222222200000000000000000222222200000000002220000000002222
22000000000022222220000000222222222000000000000002200002222220000000000000000222222200000000002200000000002222
22000000002222222000000000000220220000000000000000222000222220000000000000000222222000000000002220000000000222
22000000222222200000000000000222200000000000000000022000022222000000000000000222222000000000222220000000002222
22000022222000000000000000000022000000000000000000002222002222200000000000000000222000000000222220000000002222
22000022220000000000000000000022220000000000220000000000000222220000000000000002222000000000222220000000022222
22222020000000000000000000000022222000000002220000000000000022220000000000000002222000000000222200000000022222
22222000000000000000020000000022222000000002222000000000000000200022222222200022222000000002222220000000022022
22000000000000000000222000000002220000000022222000000000000000000022222222200002222000000002222220000000002222
22000000000000000000022000000022220000000022222000000000000000000020222022000002222200000002222220000000000222
22000000000000000000222000000022222000000002222200000000000000000000000000000002222200000002222220000000000022
22200000000000000022222000000022222200000000222220000000000000000000000000000002222200000002222220000000000022
22222000000000002222220000000022222220000000020222220000000000000000000000000002222000000002220220000000000022
22222222000000222222200000000000222020000000002222220000000000000000000000000002222000000002222220000002220022
22222222222222222200000000000002222222000000000022220000000000000000000000000000200000000002222220000002022022
22222222222222222202222000000000222202222220000002222000000000000000000000000000000000000002222220000200002222
22222222222222222202222000000000000022222220000002222200000000000000000000000000000000000022222222000200000222
22222002022022222202222000000000020222222222000000222200000000000000000000000000000000000222222222000220002222
22000002000022222222222000000000222000000220000000022222000000000000002200000000000002222222222222000022022022
22020000000022222220220000000000000000000000000000002222220000000000222200000000000022222222222222200002222222
22020000002000002220000222200000000000000000000000002222220000000002222220000002202220000222222222222202222222
22000200002222200000222222200000000000000000000000002222220000000002222220000222202200220000000002222200000222
22000200022222222222222222200000000000000000000000002222220000000222222220002222200002222222222202222222220222
22222222222222222222222222222222222222222222222222222222222222222222222222222222222222222222222200000000000222
22222222222222222222222222222222222222222222222222222222222222222222222222222222222222222222222222222222222222
